1111111111111111111111111
1000000000000000000000001
1000000000000000000000001
1000000000000000000000001
1000000000000000000000001
1000000000000000000000001
1000000000000000000000001
1000000000000000000000001
1000000000000000000000001
1000000000000000000000001
1000001111111111111100001
1000000000111110000000001
1000000000111110000000001
1000000000111110000000001
1000000000111110000000001
1000000000111110000000001
1000000000111110000000001
1000000000111110000000001
1000000000111110000000001
1000000000111110000000001
1000000000111110000000001
1000000000111110000000001
1000000000111110000000001
1000000000111110000000001
1111111111111111111111111