1111111111111111111111111
1000010000001000000000001
1000010000001000000000001
1000010000001000000000001
1000010000001000111111111
1000010000001000100000001
1000011110001000100000001
1000000010001000100000001
1000000010001000100000001
1000000010001000100000001
1000000010001000111110001
1000000010001000000000001
1000111110001000000000001
1000100000001000000000001
1000100000001000000000001
1000000000001000000000001
1000000000001000000000001
1000111111001000000000001
1000001000001000111111111
1000001000001000100000001
1000111110001000100000001
1000001000001000100000001
1000001000001000000000001
1000001000001000000000001
1111111111111111111111111