11111111111111111111111111111111111111111111111111
10000100000010000000000011000010000001000000000001
10000100000010000000000011000010000001000000000001
10000100000010000000000011000010000001000000000001
10000100000010001111111111000010000001000000000001
10000100000010001000000011000010000001000000000001
10000111100010001000000011000111111001000000000001
10000000100010001000000011000010000001000000000001
10000000100010001000000011000111111001000000000001
10000000100020001000000011000111111001000000000001
10000000100010001111100011000010000001000000000001
10000000100010000000000011000111111001000000000001
10001111100010000000000011000111111001000000000001
10001000000010000000000011000111111001000000000001
10001000000010000000000011000111111001000000000001
10000000000010000000000011000010000001000000000001
10000000000010000000000011000111111001000000000001
10001111110000000000000011000000000001000000000001
10000010000010001111111111000111111001000000000001
10000010000010001000000011000010000001000000000001
10001111100010001000000000000000000001000000000001
10000010000010001000000011000111111001000000000001
10000010000010000000000011000010000001000000000001
10000010000010000000000011000010000001000000000001
11111111111111111111111111100111111111111111111111
11111111111111111111111111101111111111111111111111
10000100000010000000000011000010000001000000000001
10000100000010000000000011000010000001000000000001
10000100000010000000000011000010000001000000000001
10000100000010001111111111000010000001000000000001
10000100000010001000000011000010000001000000000001
10000111100010001000000011000111111001000000000001
10000000100010001000000011000010000001000000000001
10000000100010001000000011000111111001000000000001
10000000100020001000000011000111111001000000000001
10000000100010001111100011000010000001000000000001
10000000100010000000000011000111111001000000000001
10001111100010000000000011000111111001000000000001
10001000000010000000000011000111111001000000000001
10001000000010000000000011000111111001000000000001
10000000000010000000000011000010000001000000000001
10000000000010000000000011000111111001000000000001
10001111110000000000000011000000000001000000000001
10000010000010001111111111000111111001000000000001
10000010000010001000000011000010000001000000000001
10001111100010001000000000000000000001000000000001
10000010000010001000000011000111111001000000000001
10000010000010000000000011000010000001000000000001
10000010000010000000000011000010000001000000000001
11111111111111111111111111111111111111111111111111